NO ./textures/urs/north_resized.xpm
SO ./textures/urs/south_resized.xpm
WE ./textures/urs/west_resized.xpm
EA ./textures/urs/east_resized.xpm
DO ./textures/urs/door_resized.xpm

C 54 , 0, 91
F 40, 0, 0
 

             111111111111111111111
             100000000000000000001
      1111111101111110111111110001
      1000000001000010100000010001
11111110111111010111101011111111111
10000000100000010000101000000000001
10111111101111111110101111111111001
10000000001000000000100000000001001
10111111111011111111101111111101001
10000000000010000000000000000D00001
10111111111010111111101111111111111
10000000000010100000001000000000001
11111111111110101111111011111111001
1000000000000010000000001000D000001
10111111111111101111111110111111101
100000000001 10000000000001000000N1
111111111111 1111111111111111111111
